Fragment_length	Missing_sites	GAATTC-GAATTC	GAATTC-CCGG	CCGG-CCGG	Sum
3	0	0	100	0	100
4	0	0	23	373	396
5	0	0	111	432	543
6	0	1	58	407	466
7	0	0	40	365	405
8	0	2	45	434	481
9	0	0	60	410	470
10	0	1	46	407	454
11	0	1	63	384	448
12	0	1	40	390	431
13	0	2	51	409	462
14	0	0	47	397	444
15	0	2	40	394	436
16	0	3	45	384	432
17	0	5	48	375	428
18	0	2	46	372	420
19	1	0	35	390	426
20	0	2	41	356	399
21	0	0	41	365	406
22	0	2	33	404	439
23	0	0	47	367	414
24	0	3	48	380	431
25	0	1	49	327	377
26	0	1	38	346	385
27	0	2	43	364	409
28	0	0	52	380	432
29	1	2	35	360	398
30	0	2	49	357	408
31	0	2	54	378	434
32	0	0	46	345	391
33	0	1	48	346	395
34	0	1	38	354	393
35	0	1	46	361	408
36	0	1	45	371	417
37	0	2	46	370	418
38	0	0	44	345	389
39	0	2	41	352	395
40	0	4	47	360	411
41	0	1	43	376	420
42	0	1	40	330	371
43	0	1	43	370	414
44	0	1	36	346	383
45	0	0	45	335	380
46	0	1	41	350	392
47	0	1	34	323	358
48	1	3	42	332	378
49	0	3	38	315	356
50	0	0	40	332	372
51	0	0	45	323	368
52	0	1	48	330	379
53	0	0	45	321	366
54	0	3	38	301	342
55	0	3	44	331	378
56	0	3	40	347	390
57	0	0	34	309	343
58	0	2	32	312	346
59	0	0	45	315	360
60	0	1	45	316	362
61	0	0	43	295	338
62	0	0	40	300	340
63	0	1	47	296	344
64	0	1	37	313	351
65	0	3	45	322	370
66	0	1	47	318	366
67	0	2	38	306	346
68	0	1	29	312	342
69	1	1	37	294	333
70	0	2	38	299	339
71	0	0	41	307	348
72	0	0	41	281	322
73	0	1	34	312	347
74	0	0	45	292	337
75	1	2	33	287	323
76	0	1	32	308	341
77	0	2	43	293	338
78	0	1	30	313	344
79	0	1	44	313	358
80	0	0	40	321	361
81	0	0	27	308	335
82	0	1	34	301	336
83	0	2	30	281	313
84	0	2	36	276	314
85	0	1	37	282	320
86	0	3	31	337	371
87	0	0	31	281	312
88	0	2	23	287	312
89	1	0	37	293	331
90	1	0	30	264	295
91	0	0	32	287	319
92	0	0	35	319	354
93	0	1	48	294	343
94	0	0	23	259	282
95	0	1	32	249	282
96	0	0	33	290	323
97	0	0	30	294	324
98	0	0	29	267	296
99	0	3	26	301	330
100	0	0	24	254	278
101	0	0	33	267	300
102	0	1	30	286	317
103	0	0	32	250	282
104	0	5	30	244	279
105	0	1	33	297	331
106	0	1	45	276	322
107	0	3	22	244	269
108	0	3	38	261	302
109	0	0	28	264	292
110	0	1	31	255	287
111	2	2	37	250	291
112	0	0	35	277	312
113	0	1	32	253	286
114	0	1	35	254	290
115	0	0	42	268	310
116	0	0	36	239	275
117	0	1	36	277	314
118	0	1	39	259	299
119	0	0	31	271	302
120	0	1	26	236	263
121	0	1	29	232	262
122	0	1	35	229	265
123	0	0	27	243	270
124	0	0	26	231	257
125	0	3	38	261	302
126	0	0	31	243	274
127	0	2	28	261	291
128	0	0	34	264	298
129	0	0	21	246	267
130	0	0	28	217	245
131	0	1	26	244	271
132	0	0	19	211	230
133	1	0	20	215	236
134	0	0	26	229	255
135	0	0	27	259	286
136	0	0	35	254	289
137	0	1	21	218	240
138	0	0	26	238	264
139	0	0	29	239	268
140	0	0	22	228	250
141	0	3	24	220	247
142	0	2	27	216	245
143	0	1	26	208	235
144	0	0	28	220	248
145	0	1	28	223	252
146	0	1	29	226	256
147	0	2	21	215	238
148	1	1	24	234	260
149	0	1	33	225	259
150	0	0	33	201	234
151	0	3	24	213	240
152	0	1	20	221	242
153	0	1	28	217	246
154	0	1	32	218	251
155	0	1	29	194	224
156	0	0	24	202	226
157	0	0	29	215	244
158	0	0	30	212	242
159	0	0	40	221	261
160	0	1	30	205	236
161	0	1	22	217	240
162	0	0	30	228	258
163	0	0	34	182	216
164	0	2	26	194	222
165	0	0	25	234	259
166	0	1	22	230	253
167	0	1	38	216	255
168	0	0	22	213	235
169	0	0	15	208	223
170	0	3	26	208	237
171	0	0	22	187	209
172	0	2	27	230	259
173	0	1	26	200	227
174	0	0	26	216	242
175	0	1	25	169	195
176	0	1	15	176	192
177	1	2	21	183	207
178	0	0	25	185	210
179	0	0	26	163	189
180	0	0	17	185	202
181	0	1	24	179	204
182	0	0	36	224	260
183	0	2	24	205	231
184	0	2	22	191	215
185	1	0	18	203	222
186	0	2	25	175	202
187	0	0	14	196	210
188	0	0	28	191	219
189	0	2	24	209	235
190	0	0	29	188	217
191	0	1	15	198	214
192	0	1	20	182	203
193	0	1	30	182	213
194	0	0	24	176	200
195	0	0	21	168	189
196	0	0	26	198	224
197	0	1	21	169	191
198	0	0	22	207	229
199	0	0	26	163	189
200	0	0	14	178	192
201	0	0	22	155	177
202	0	0	21	178	199
203	0	0	23	189	212
204	0	1	12	178	191
205	0	1	17	160	178
206	0	0	21	166	187
207	0	4	29	171	204
208	0	1	35	167	203
209	0	1	20	163	184
210	0	1	15	187	203
211	0	0	24	180	204
212	0	0	24	184	208
213	0	1	17	182	200
214	0	0	21	163	184
215	0	1	23	164	188
216	0	1	17	178	196
217	0	0	19	165	184
218	0	1	22	158	181
219	0	0	26	160	186
220	0	0	29	168	197
221	0	1	21	149	171
222	0	0	23	153	176
223	0	1	16	166	183
224	0	0	26	177	203
225	0	1	25	157	183
226	0	0	18	153	171
227	0	0	18	165	183
228	0	1	10	158	169
229	0	1	26	155	182
230	0	1	15	162	178
231	0	2	19	161	182
232	0	1	18	158	177
233	0	0	17	159	176
234	1	0	22	148	171
235	0	0	27	139	166
236	0	3	19	168	190
237	0	0	21	152	173
238	0	1	20	134	155
239	0	1	14	158	173
240	0	1	18	168	187
241	0	1	11	149	161
242	0	0	29	155	184
243	0	1	18	147	166
244	0	0	14	127	141
245	0	0	15	154	169
246	0	2	18	155	175
247	0	2	13	137	152
248	0	0	17	152	169
249	0	0	17	141	158
250	1	1	20	148	170
251	0	0	12	137	149
252	0	0	23	154	177
253	0	1	15	148	164
254	0	1	20	119	140
255	0	0	17	140	157
256	0	0	12	127	139
257	0	1	18	151	170
258	0	0	12	125	137
259	0	0	22	139	161
260	0	0	18	136	154
261	0	0	16	136	152
262	0	1	17	150	168
263	0	1	15	158	174
264	0	1	19	112	132
265	0	0	18	133	151
266	0	0	23	154	177
267	0	0	16	152	168
268	0	0	15	118	133
269	0	1	22	143	166
270	0	0	13	138	151
271	0	1	17	124	142
272	0	2	15	136	153
273	0	0	19	134	153
274	0	1	18	120	139
275	0	0	10	133	143
276	0	1	12	124	137
277	0	0	12	128	140
278	0	2	25	134	161
279	0	0	16	125	141
280	1	0	13	117	131
281	0	1	15	135	151
282	0	1	18	106	125
283	0	0	17	120	137
284	0	1	24	119	144
285	0	1	14	124	139
286	0	0	16	127	143
287	0	0	14	110	124
288	0	2	14	129	145
289	0	1	26	121	148
290	0	2	20	123	145
291	0	0	21	121	142
292	0	0	14	126	140
293	0	0	18	127	145
294	0	2	19	99	120
295	0	0	9	126	135
296	0	0	18	124	142
297	0	0	16	121	137
298	0	0	14	118	132
299	0	0	20	106	126
300	0	1	19	126	146
301	0	0	11	121	132
302	0	1	13	95	109
303	0	1	15	129	145
304	0	0	16	109	125
305	0	0	11	102	113
306	0	1	12	102	115
307	0	0	15	107	122
308	0	1	12	123	136
309	0	0	12	98	110
310	0	0	20	118	138
311	0	0	9	130	139
312	0	1	10	101	112
313	0	0	19	111	130
314	0	0	12	96	108
315	0	0	11	118	129
316	0	0	12	112	124
317	0	0	15	128	143
318	0	0	13	93	106
319	0	0	17	101	118
320	0	0	16	117	133
321	0	0	9	112	121
322	0	1	13	92	106
323	0	0	10	127	137
324	0	0	7	137	144
325	0	0	8	115	123
326	0	2	16	110	128
327	0	0	9	99	108
328	0	0	21	116	137
329	0	0	20	109	129
330	0	0	13	117	130
331	0	0	14	109	123
332	0	0	9	96	105
333	0	0	15	109	124
334	0	1	14	123	138
335	0	0	14	90	104
336	0	0	12	113	125
337	0	0	14	105	119
338	0	1	16	79	96
339	0	1	15	75	91
340	1	1	14	99	115
341	0	0	15	100	115
342	0	0	12	99	111
343	0	1	7	113	121
344	0	1	9	88	98
345	0	0	10	106	116
346	0	0	11	94	105
347	0	0	10	78	88
348	0	0	8	83	91
349	0	1	18	102	121
350	0	0	11	94	105
351	0	0	9	105	114
352	0	0	15	92	107
353	0	0	7	88	95
354	0	0	14	98	112
355	0	1	11	96	108
356	0	0	16	96	112
357	0	0	9	98	107
358	0	0	7	109	116
359	0	0	14	84	98
360	0	0	12	109	121
361	0	0	14	91	105
362	0	0	10	100	110
363	0	1	3	83	87
364	0	0	11	86	97
365	0	0	6	97	103
366	0	0	14	97	111
367	0	0	7	91	98
368	0	1	11	87	99
369	0	0	17	88	105
370	0	0	12	91	103
371	0	0	10	101	111
372	0	1	10	86	97
373	0	0	10	76	86
374	0	0	9	91	100
375	0	0	9	71	80
376	0	0	8	83	91
377	0	0	10	74	84
378	0	0	10	87	97
379	0	0	12	82	94
380	0	2	7	89	98
381	0	0	10	85	95
382	0	0	13	77	90
383	0	0	10	82	92
384	0	0	9	105	114
385	0	2	7	83	92
386	0	1	6	92	99
387	0	0	10	83	93
388	0	0	11	73	84
389	0	1	7	92	100
390	0	1	11	67	79
391	0	1	6	91	98
392	0	0	13	74	87
393	0	0	10	96	106
394	0	0	10	90	100
395	0	0	16	74	90
396	0	0	12	75	87
397	0	0	10	86	96
398	0	0	12	75	87
399	0	1	9	73	83
400	0	1	13	72	86
401	0	0	6	73	79
402	0	0	6	73	79
403	0	1	13	66	80
404	0	0	3	81	84
405	0	0	13	70	83
406	0	0	11	53	64
407	0	0	11	68	79
408	0	0	9	53	62
409	0	0	7	65	72
410	0	1	6	76	83
411	0	0	12	71	83
412	0	0	10	70	80
413	0	1	11	72	84
414	0	0	10	65	75
415	0	1	10	86	97
416	0	0	5	72	77
417	0	0	11	65	76
418	0	1	5	68	74
419	0	0	12	71	83
420	0	0	8	72	80
421	0	0	10	81	91
422	0	0	5	77	82
423	0	0	12	68	80
424	0	0	8	65	73
425	0	1	10	64	75
426	0	1	6	66	73
427	0	0	6	45	51
428	0	0	10	69	79
429	0	1	6	61	68
430	0	1	12	82	95
431	0	0	11	67	78
432	0	0	6	63	69
433	0	1	7	58	66
434	0	0	7	71	78
435	0	0	9	63	72
436	0	0	10	82	92
437	0	0	9	56	65
438	0	1	9	62	72
439	0	0	8	62	70
440	0	0	5	79	84
441	0	0	8	75	83
442	0	0	9	67	76
443	0	0	8	75	83
444	0	2	6	59	67
445	0	0	13	79	92
446	0	0	11	58	69
447	0	1	13	53	67
448	0	0	6	71	77
449	0	0	11	62	73
450	0	1	7	63	71
451	0	0	10	53	63
452	0	0	3	61	64
453	0	1	8	49	58
454	0	0	10	51	61
455	0	0	7	61	68
456	0	1	11	57	69
457	0	0	6	72	78
458	0	0	3	66	69
459	0	0	9	60	69
460	0	0	10	58	68
461	0	0	4	62	66
462	0	0	7	48	55
463	0	0	7	54	61
464	0	0	12	50	62
465	0	0	3	64	67
466	0	0	3	50	53
467	0	1	3	56	60
468	0	0	6	62	68
469	0	1	4	58	63
470	0	0	8	56	64
471	0	1	5	67	73
472	0	0	6	51	57
473	0	0	7	54	61
474	0	0	5	52	57
475	0	0	7	45	52
476	0	0	3	43	46
477	0	0	6	44	50
478	0	0	4	55	59
479	0	0	9	49	58
480	0	0	9	51	60
481	0	0	1	61	62
482	0	1	8	39	48
483	0	0	8	48	56
484	0	0	9	55	64
485	0	0	5	63	68
486	0	0	6	52	58
487	0	0	5	48	53
488	0	1	4	53	58
489	0	1	8	63	72
490	0	1	3	45	49
491	0	1	7	64	72
492	0	0	5	54	59
493	0	0	2	47	49
494	0	1	5	41	47
495	0	0	4	36	40
496	0	0	4	50	54
497	0	0	8	42	50
498	0	0	3	40	43
499	0	0	4	46	50
500	0	0	7	54	61
501	0	0	5	51	56
502	0	0	5	46	51
503	0	0	2	58	60
504	0	0	5	44	49
505	0	0	9	59	68
506	0	0	4	49	53
507	0	1	6	49	56
508	0	0	5	60	65
509	0	0	8	45	53
510	0	0	5	64	69
511	0	0	11	52	63
512	0	0	8	48	56
513	0	0	7	55	62
514	0	0	4	47	51
515	0	1	5	51	57
516	0	0	6	47	53
517	0	1	3	44	48
518	0	0	5	44	49
519	0	0	6	54	60
520	0	0	5	45	50
521	0	0	7	48	55
522	0	0	9	44	53
523	0	0	5	55	60
524	0	0	7	47	54
525	0	0	5	50	55
526	0	0	1	41	42
527	0	1	9	48	58
528	0	0	5	50	55
529	0	0	4	57	61
530	0	1	4	42	47
531	0	0	11	45	56
532	0	0	5	51	56
533	0	0	6	47	53
534	0	0	5	52	57
535	0	0	10	30	40
536	0	0	5	48	53
537	0	1	5	37	43
538	0	0	6	51	57
539	0	0	1	38	39
540	0	1	3	50	54
541	0	0	5	41	46
542	0	0	6	35	41
543	0	0	4	37	41
544	0	0	2	44	46
545	0	0	3	47	50
546	0	0	2	45	47
547	0	0	3	53	56
548	0	0	11	47	58
549	0	0	5	47	52
550	0	0	4	40	44
551	0	0	4	37	41
552	0	1	8	42	51
553	0	0	7	46	53
554	0	0	5	35	40
555	0	0	6	37	43
556	0	1	3	61	65
557	0	0	6	40	46
558	0	0	4	32	36
559	0	0	6	51	57
560	0	0	5	42	47
561	0	0	7	43	50
562	0	0	2	41	43
563	0	0	5	41	46
564	0	0	4	44	48
565	0	0	5	38	43
566	0	0	8	44	52
567	0	0	6	38	44
568	0	0	6	44	50
569	0	0	5	28	33
570	0	0	6	30	36
571	0	0	6	30	36
572	0	0	8	33	41
573	0	0	3	35	38
574	0	1	5	30	36
575	0	0	6	37	43
576	0	1	4	40	45
577	0	0	4	40	44
578	0	0	5	35	40
579	0	0	5	46	51
580	0	0	4	44	48
581	0	1	3	35	39
582	0	0	4	37	41
583	0	0	3	39	42
584	0	0	4	44	48
585	0	0	7	38	45
586	0	0	5	49	54
587	0	0	10	41	51
588	0	0	5	25	30
589	0	0	3	35	38
590	0	1	6	37	44
591	0	0	3	35	38
592	0	0	5	34	39
593	0	0	5	33	38
594	0	0	7	26	33
595	0	0	5	32	37
596	0	0	2	41	43
597	0	0	1	36	37
598	0	0	4	39	43
599	0	1	5	35	41
600	0	0	8	26	34
601	0	0	5	38	43
602	0	0	9	37	46
603	0	1	2	40	43
604	0	0	5	42	47
605	0	0	4	37	41
606	0	0	4	31	35
607	0	0	2	33	35
608	0	0	3	33	36
609	0	0	0	24	24
610	0	0	6	22	28
611	0	0	6	28	34
612	0	0	3	21	24
613	0	0	4	26	30
614	0	1	3	20	24
615	0	0	2	29	31
616	0	1	3	33	37
617	0	0	4	42	46
618	0	0	2	27	29
619	0	0	3	26	29
620	0	1	2	28	31
621	0	1	5	28	34
622	0	0	5	34	39
623	0	0	4	35	39
624	0	0	5	26	31
625	0	0	4	28	32
626	0	0	1	30	31
627	0	0	2	41	43
628	0	0	2	31	33
629	0	0	3	29	32
630	0	0	2	25	27
631	0	0	7	28	35
632	0	0	1	30	31
633	0	0	4	20	24
634	0	0	1	31	32
635	0	0	2	15	17
636	0	0	4	34	38
637	0	0	4	29	33
638	0	0	1	41	42
639	0	0	4	31	35
640	0	0	6	31	37
641	0	0	1	27	28
642	0	0	6	27	33
643	0	0	1	22	23
644	0	0	1	25	26
645	0	0	2	30	32
646	0	1	5	33	39
647	0	0	6	21	27
648	0	0	3	31	34
649	0	0	1	30	31
650	0	0	1	18	19
651	0	0	2	29	31
652	0	0	1	35	36
653	0	0	1	28	29
654	0	0	4	18	22
655	0	0	2	28	30
656	0	0	0	17	17
657	0	0	2	20	22
658	0	1	1	33	35
659	0	0	2	20	22
660	0	0	7	32	39
661	0	0	1	25	26
662	0	0	1	21	22
663	0	1	4	26	31
664	0	0	4	21	25
665	0	0	9	27	36
666	0	0	4	23	27
667	0	0	1	33	34
668	0	0	5	27	32
669	0	0	4	23	27
670	0	0	2	26	28
671	0	0	3	25	28
672	0	0	1	18	19
673	0	0	1	25	26
674	0	0	6	18	24
675	0	0	4	31	35
676	0	0	1	20	21
677	0	0	2	10	12
678	0	0	4	28	32
679	0	0	0	22	22
680	0	0	0	31	31
681	0	0	3	23	26
682	0	0	5	37	42
683	0	0	2	25	27
684	0	0	3	21	24
685	0	0	2	26	28
686	0	1	4	22	27
687	0	0	3	24	27
688	0	0	4	16	20
689	0	0	1	19	20
690	0	1	5	14	20
691	0	0	5	24	29
692	0	0	2	20	22
693	0	0	4	24	28
694	0	0	3	25	28
695	0	0	3	24	27
696	0	0	5	26	31
697	0	0	3	21	24
698	0	0	0	25	25
699	0	0	3	22	25
700	0	0	1	24	25
701	0	1	1	16	18
702	0	0	4	14	18
703	0	0	2	23	25
704	0	0	5	25	30
705	0	0	3	23	26
706	0	0	2	31	33
707	0	0	3	29	32
708	0	0	3	25	28
709	0	0	2	18	20
710	0	0	3	15	18
711	0	0	3	19	22
712	0	0	2	27	29
713	0	0	2	20	22
714	0	0	2	23	25
715	0	0	2	21	23
716	0	0	2	25	27
717	0	0	3	20	23
718	0	0	1	22	23
719	0	1	1	24	26
720	0	0	1	19	20
721	0	0	1	16	17
722	0	0	0	17	17
723	0	0	2	20	22
724	0	0	1	14	15
725	0	0	3	21	24
726	0	0	4	17	21
727	0	0	3	20	23
728	0	1	3	28	32
729	0	0	3	16	19
730	0	0	2	19	21
731	0	0	2	19	21
732	0	0	1	25	26
733	0	0	1	20	21
734	0	0	1	21	22
735	0	0	5	14	19
736	0	0	2	12	14
737	1	0	4	15	20
738	0	0	2	21	23
739	0	0	1	8	9
740	0	0	6	17	23
741	0	0	3	18	21
742	0	0	2	17	19
743	0	0	1	19	20
744	0	0	3	27	30
745	0	0	1	23	24
746	0	0	5	18	23
747	0	0	1	18	19
748	0	0	3	17	20
749	0	0	2	17	19
750	0	0	1	22	23
751	0	0	3	28	31
752	0	0	3	21	24
753	0	1	1	20	22
754	0	0	3	23	26
755	0	0	3	11	14
756	0	1	3	16	20
757	0	0	1	19	20
758	0	0	2	18	20
759	0	0	4	13	17
760	0	1	1	24	26
761	0	0	2	13	15
762	0	0	2	15	17
763	0	0	1	19	20
764	0	0	2	11	13
765	0	0	2	21	23
766	0	0	1	18	19
767	0	0	0	13	13
768	0	0	2	12	14
769	0	0	2	19	21
770	0	0	3	12	15
771	0	0	1	21	22
772	0	0	3	17	20
773	0	0	3	8	11
774	0	0	1	10	11
775	0	0	4	14	18
776	0	0	3	23	26
777	0	0	1	7	8
778	0	0	2	15	17
779	0	0	2	9	11
780	0	0	2	13	15
781	0	0	2	12	14
782	0	0	7	15	22
783	0	0	1	17	18
784	0	0	4	15	19
785	0	0	3	18	21
786	0	0	3	14	17
787	0	0	0	17	17
788	0	0	2	14	16
789	0	0	2	15	17
790	0	0	2	20	22
791	0	0	1	17	18
792	0	0	0	17	17
793	0	0	0	10	10
794	0	0	1	19	20
795	0	0	2	25	27
796	0	0	4	14	18
797	0	0	3	16	19
798	0	0	2	16	18
799	0	0	3	12	15
800	0	0	4	15	19
801	0	0	0	7	7
802	0	0	0	13	13
803	0	0	0	13	13
804	0	0	0	6	6
805	0	0	0	16	16
806	0	0	3	10	13
807	0	0	1	16	17
808	0	0	2	11	13
809	0	0	2	13	15
810	0	0	1	17	18
811	0	0	3	13	16
812	0	0	0	16	16
813	0	0	3	6	9
814	0	0	1	7	8
815	0	0	0	16	16
816	0	0	1	11	12
817	0	0	1	7	8
818	0	0	2	15	17
819	0	0	1	11	12
820	0	0	1	17	18
821	0	0	1	13	14
822	0	0	0	10	10
823	0	0	0	12	12
824	0	0	3	15	18
825	0	0	1	15	16
826	0	0	1	15	16
827	0	0	4	16	20
828	0	0	3	10	13
829	0	0	0	15	15
830	0	0	1	9	10
831	0	0	2	8	10
832	0	0	4	11	15
833	0	0	1	17	18
834	0	0	2	11	13
835	0	0	1	9	10
836	0	0	0	12	12
837	0	0	1	10	11
838	0	0	3	11	14
839	0	0	3	14	17
840	0	0	1	14	15
841	0	0	1	15	16
842	0	0	3	4	7
843	0	0	0	13	13
844	0	0	1	13	14
845	0	0	2	6	8
846	0	0	1	12	13
847	0	0	3	10	13
848	0	0	2	16	18
849	0	0	1	10	11
850	0	0	3	16	19
851	0	0	1	10	11
852	0	0	1	13	14
853	0	0	1	7	8
854	0	0	2	11	13
855	0	0	2	11	13
856	0	0	1	11	12
857	0	0	1	8	9
858	0	0	1	14	15
859	0	0	1	7	8
860	0	0	0	9	9
861	0	0	2	8	10
862	0	0	1	7	8
863	0	0	1	13	14
864	0	1	1	9	11
865	0	0	1	15	16
866	0	0	3	13	16
867	0	0	3	9	12
868	0	0	1	11	12
869	0	0	1	12	13
870	0	0	2	13	15
871	0	0	1	13	14
872	0	0	0	8	8
873	0	1	2	13	16
874	0	0	2	17	19
875	0	0	1	7	8
876	0	0	3	6	9
877	0	0	1	11	12
878	0	0	2	12	14
879	0	0	3	11	14
880	0	0	1	8	9
881	0	0	5	9	14
882	0	0	0	7	7
883	0	0	3	16	19
884	0	0	2	16	18
885	0	0	0	11	11
886	0	0	2	10	12
887	0	0	1	10	11
888	0	0	1	8	9
889	0	0	1	8	9
890	0	0	0	16	16
891	0	0	0	8	8
892	0	0	0	8	8
893	0	0	6	10	16
894	0	0	1	9	10
895	0	0	0	10	10
896	0	0	1	7	8
897	0	0	0	11	11
898	0	0	0	13	13
899	0	0	2	8	10
900	0	0	0	5	5
901	0	0	1	14	15
902	0	0	2	14	16
903	0	0	0	10	10
904	0	0	2	9	11
905	0	0	2	9	11
906	0	0	0	8	8
907	0	0	0	10	10
908	0	0	0	8	8
909	0	0	1	10	11
910	0	0	2	6	8
911	0	0	2	11	13
912	0	0	2	7	9
913	0	0	2	8	10
914	0	0	0	7	7
915	0	0	1	14	15
916	0	0	0	5	5
917	0	0	0	10	10
918	0	0	0	5	5
919	0	0	1	10	11
920	0	0	0	12	12
921	0	0	1	12	13
922	0	0	0	10	10
923	0	0	2	11	13
924	0	0	1	9	10
925	0	0	3	21	24
926	0	0	1	10	11
927	0	0	3	7	10
928	0	0	0	4	4
929	0	0	1	11	12
930	0	0	1	7	8
931	0	0	0	7	7
932	0	0	1	3	4
933	0	0	1	5	6
934	0	0	1	6	7
935	0	0	0	10	10
936	0	0	2	3	5
937	0	0	0	9	9
938	0	0	0	3	3
939	0	0	1	8	9
940	0	0	1	9	10
941	0	0	4	10	14
942	0	0	1	10	11
943	0	0	1	6	7
944	0	0	1	8	9
945	0	0	0	5	5
946	0	0	0	8	8
947	0	0	1	5	6
948	0	0	1	8	9
949	0	0	0	5	5
950	0	0	3	7	10
951	0	0	0	5	5
952	0	0	1	7	8
953	0	0	0	6	6
954	0	0	0	5	5
955	0	0	1	7	8
956	0	0	0	6	6
957	0	0	2	6	8
958	0	0	1	6	7
959	0	0	0	9	9
960	0	0	0	9	9
961	0	0	4	7	11
962	0	0	2	6	8
963	0	0	0	10	10
964	0	0	2	6	8
965	0	0	2	2	4
966	0	0	2	6	8
967	0	0	2	9	11
968	0	0	0	4	4
969	0	0	0	8	8
970	0	0	1	11	12
971	0	0	1	9	10
972	0	0	2	9	11
973	0	0	1	4	5
974	0	0	0	12	12
975	0	0	0	12	12
976	0	0	0	8	8
977	0	0	1	9	10
978	0	0	0	5	5
979	0	0	2	6	8
980	0	0	1	10	11
981	0	0	0	6	6
982	0	0	1	6	7
983	0	0	1	3	4
984	0	0	2	5	7
985	0	0	0	12	12
986	0	0	0	7	7
987	0	0	0	7	7
988	0	0	3	8	11
989	0	0	0	8	8
990	0	0	0	3	3
991	0	0	0	9	9
992	0	0	1	5	6
993	0	0	1	7	8
994	0	0	1	5	6
995	0	0	0	3	3
996	0	0	1	9	10
997	0	0	1	2	3
998	0	0	1	5	6
999	0	0	0	6	6
1000	0	0	1	6	7
1001	0	0	0	4	4
1002	0	0	1	14	15
1003	0	0	1	7	8
1004	0	0	0	9	9
1005	0	0	1	3	4
1006	0	0	1	9	10
1007	0	0	0	9	9
1008	0	0	0	2	2
1009	0	0	2	5	7
1010	0	0	3	9	12
1011	0	0	0	8	8
1012	0	0	1	8	9
1013	0	0	0	6	6
1014	0	0	0	5	5
1015	0	0	0	2	2
1016	0	0	0	5	5
1017	0	0	2	5	7
1018	0	0	0	6	6
1019	0	0	3	6	9
1020	0	0	0	6	6
1021	0	0	1	6	7
1022	0	0	1	4	5
1023	0	0	1	7	8
1024	0	0	0	6	6
1025	0	0	1	9	10
1026	0	0	0	7	7
1027	0	0	0	4	4
1028	0	0	1	3	4
1029	0	0	0	9	9
1030	0	0	2	5	7
1031	0	0	1	5	6
1032	0	0	0	9	9
1033	0	0	1	6	7
1034	0	0	1	4	5
1035	0	0	1	6	7
1036	0	0	0	6	6
1037	0	0	0	7	7
1038	0	0	2	8	10
1039	0	0	1	4	5
1040	0	0	1	3	4
1041	0	0	1	6	7
1042	0	0	0	3	3
1043	0	0	0	5	5
1044	0	0	2	5	7
1045	0	0	1	6	7
1046	0	0	1	4	5
1047	0	0	0	5	5
1048	0	0	0	2	2
1049	0	0	2	4	6
1050	0	0	0	3	3
1051	0	0	0	7	7
1052	0	0	0	3	3
1053	0	0	0	4	4
1054	0	0	0	7	7
1055	0	0	1	6	7
1056	0	1	0	5	6
1057	0	0	0	6	6
1058	0	0	0	5	5
1059	0	0	0	6	6
1060	0	0	0	10	10
1061	0	0	0	9	9
1062	0	0	1	6	7
1063	0	0	0	6	6
1064	0	0	0	10	10
1065	0	0	1	7	8
1066	0	0	0	2	2
1067	0	0	1	6	7
1068	0	0	1	2	3
1069	0	0	1	4	5
1070	0	0	0	4	4
1071	0	0	0	8	8
1072	0	0	0	6	6
1073	0	0	0	2	2
1074	0	0	1	3	4
1075	0	0	0	3	3
1076	0	0	1	4	5
1077	0	0	1	3	4
1078	0	0	0	5	5
1079	0	0	0	2	2
1080	0	0	0	2	2
1081	0	0	0	9	9
1082	0	0	1	5	6
1083	0	0	2	4	6
1084	0	0	0	5	5
1085	0	0	0	2	2
1086	0	0	1	6	7
1087	0	0	0	4	4
1088	0	0	2	2	4
1089	0	0	1	2	3
1090	0	0	1	1	2
1091	0	0	1	5	6
1092	0	0	0	2	2
1093	0	0	0	2	2
1094	0	0	1	4	5
1095	0	0	1	5	6
1096	0	0	2	4	6
1098	0	0	0	8	8
1099	0	0	0	2	2
1100	0	0	1	2	3
1101	0	0	2	5	7
1102	0	0	0	3	3
1103	0	0	0	2	2
1104	0	0	0	7	7
1105	0	0	0	2	2
1106	0	0	0	4	4
1107	0	0	1	4	5
1108	0	0	1	1	2
1109	0	0	0	6	6
1110	0	0	1	9	10
1111	0	0	0	3	3
1112	0	0	0	1	1
1113	0	0	0	6	6
1114	0	0	1	3	4
1115	0	0	1	5	6
1116	0	0	0	7	7
1117	0	0	0	5	5
1118	0	0	0	4	4
1119	0	0	1	1	2
1120	0	0	2	4	6
1121	0	0	0	2	2
1122	0	0	2	3	5
1123	0	0	0	4	4
1124	0	0	1	4	5
1125	0	0	0	2	2
1126	0	0	0	4	4
1127	0	0	0	5	5
1128	0	0	4	2	6
1129	0	0	0	5	5
1130	0	0	0	9	9
1131	0	0	1	7	8
1132	0	0	0	3	3
1133	0	0	0	3	3
1134	0	0	0	2	2
1135	0	0	0	4	4
1136	0	0	2	0	2
1137	0	0	1	4	5
1138	0	0	1	5	6
1139	0	0	0	3	3
1140	0	0	1	1	2
1141	0	0	0	4	4
1142	0	0	1	2	3
1143	0	0	0	4	4
1144	0	0	0	5	5
1145	0	0	0	1	1
1146	0	0	0	2	2
1147	0	0	0	5	5
1148	0	0	0	2	2
1149	0	0	0	3	3
1150	0	0	0	5	5
1151	0	0	1	5	6
1152	0	0	0	8	8
1153	0	0	1	0	1
1154	0	0	2	3	5
1155	0	0	1	3	4
1156	0	0	0	5	5
1157	0	1	1	3	5
1158	0	0	0	2	2
1159	0	0	1	7	8
1160	0	0	0	2	2
1161	0	0	0	4	4
1162	0	0	1	1	2
1163	0	0	3	3	6
1164	0	0	0	3	3
1165	0	0	0	1	1
1167	0	0	0	3	3
1168	0	0	1	3	4
1169	0	0	1	7	8
1170	0	0	1	1	2
1171	0	0	0	1	1
1172	0	0	0	2	2
1173	0	0	0	5	5
1174	0	0	0	3	3
1175	0	0	0	6	6
1176	0	0	1	3	4
1177	0	0	3	3	6
1178	0	0	1	3	4
1179	0	0	0	1	1
1180	0	0	0	2	2
1181	0	0	0	1	1
1182	0	0	1	2	3
1183	0	0	0	4	4
1184	0	0	1	4	5
1185	0	0	1	3	4
1186	0	0	1	1	2
1187	0	0	0	3	3
1188	0	0	0	2	2
1189	0	0	1	2	3
1190	0	0	1	6	7
1191	0	0	0	1	1
1193	0	0	0	5	5
1194	0	0	0	3	3
1195	0	0	0	5	5
1196	0	0	0	2	2
1197	1	0	0	3	4
1198	0	0	1	2	3
1199	0	0	0	5	5
1200	0	0	1	1	2
1201	0	0	0	1	1
1202	0	0	1	5	6
1203	0	0	0	2	2
1204	0	0	0	3	3
1205	0	0	1	1	2
1206	0	0	1	5	6
1207	0	0	0	5	5
1209	0	0	1	3	4
1211	0	0	1	1	2
1212	0	0	0	3	3
1213	0	0	0	1	1
1214	0	0	0	1	1
1215	0	0	0	3	3
1216	0	0	0	1	1
1217	0	0	0	4	4
1219	0	0	0	3	3
1220	0	0	1	9	10
1221	0	0	0	4	4
1222	0	0	1	5	6
1223	0	0	0	4	4
1224	0	0	0	2	2
1225	0	0	1	2	3
1226	0	0	0	3	3
1227	0	0	0	1	1
1228	0	0	0	5	5
1229	0	0	0	4	4
1230	0	0	0	2	2
1231	0	0	0	1	1
1232	1	0	1	3	5
1233	0	0	0	4	4
1234	0	0	0	5	5
1235	0	0	1	1	2
1236	0	0	0	2	2
1237	0	0	1	6	7
1238	0	0	1	2	3
1240	0	0	0	4	4
1241	0	0	0	2	2
1242	0	0	1	3	4
1243	0	0	0	1	1
1244	0	0	1	2	3
1245	0	0	0	3	3
1246	0	0	0	3	3
1247	0	0	0	3	3
1248	0	0	0	3	3
1249	0	0	0	2	2
1250	0	0	0	3	3
1251	0	0	1	2	3
1252	0	0	0	2	2
1253	0	0	1	2	3
1254	0	0	1	3	4
1255	0	0	1	2	3
1256	0	0	0	3	3
1257	0	0	0	1	1
1258	0	0	0	2	2
1259	0	0	0	3	3
1260	0	0	0	1	1
1261	0	1	0	1	2
1262	0	0	0	1	1
1263	0	0	1	2	3
1264	0	0	0	1	1
1265	0	0	0	3	3
1267	0	0	0	1	1
1268	0	0	0	2	2
1269	0	0	0	4	4
1270	0	0	1	4	5
1271	0	0	0	3	3
1272	0	0	0	3	3
1273	0	0	0	3	3
1274	0	0	0	1	1
1275	0	0	0	1	1
1276	0	0	0	1	1
1277	0	0	1	2	3
1278	0	0	0	3	3
1279	0	0	0	2	2
1280	0	0	0	2	2
1281	0	0	0	3	3
1282	0	0	0	2	2
1283	0	0	0	5	5
1284	0	0	0	1	1
1285	0	0	0	1	1
1286	0	0	0	1	1
1287	0	0	0	6	6
1288	0	0	0	4	4
1289	0	0	0	1	1
1290	0	0	0	2	2
1291	0	0	1	2	3
1292	0	0	0	1	1
1293	0	0	0	3	3
1294	0	0	0	1	1
1295	0	0	1	0	1
1296	0	0	0	1	1
1297	0	0	1	1	2
1298	0	0	0	2	2
1299	0	0	0	3	3
1300	0	0	1	4	5
1301	0	0	0	1	1
1302	0	0	0	4	4
1303	0	0	0	1	1
1304	0	0	1	1	2
1305	0	0	1	2	3
1306	0	0	0	1	1
1307	0	0	0	2	2
1308	0	0	0	1	1
1309	0	0	0	2	2
1310	0	0	1	2	3
1312	0	0	0	4	4
1313	0	0	1	4	5
1314	0	0	0	3	3
1316	0	0	0	1	1
1317	0	0	0	2	2
1318	0	0	1	1	2
1320	0	0	0	3	3
1323	0	0	0	1	1
1327	0	0	0	2	2
1328	0	0	0	3	3
1329	0	0	0	7	7
1330	0	0	0	3	3
1331	0	0	2	1	3
1332	0	0	0	3	3
1333	0	0	0	3	3
1334	0	0	0	3	3
1335	0	0	1	1	2
1337	0	0	0	4	4
1338	0	0	1	1	2
1339	0	0	0	2	2
1340	0	0	0	2	2
1341	0	0	0	2	2
1342	0	0	0	1	1
1343	0	0	0	2	2
1344	0	0	1	1	2
1345	0	0	0	1	1
1347	0	0	0	2	2
1348	0	0	0	1	1
1349	0	0	0	2	2
1350	0	0	0	1	1
1352	0	0	0	3	3
1353	0	0	0	1	1
1354	0	0	0	1	1
1355	0	0	0	2	2
1356	0	0	2	0	2
1357	0	0	0	2	2
1361	0	0	0	2	2
1362	0	0	0	3	3
1363	0	0	0	1	1
1364	0	0	0	2	2
1365	0	0	0	2	2
1366	0	0	0	3	3
1370	0	0	0	2	2
1371	0	0	0	2	2
1373	0	0	0	3	3
1378	0	0	0	4	4
1379	0	0	0	2	2
1380	0	0	1	1	2
1382	0	0	0	1	1
1383	0	0	0	2	2
1384	0	0	0	1	1
1385	0	0	1	0	1
1386	0	0	1	2	3
1388	0	0	0	1	1
1389	0	0	0	1	1
1390	0	0	0	1	1
1391	0	0	0	1	1
1392	0	0	0	1	1
1393	0	0	0	3	3
1394	0	0	0	1	1
1395	0	0	0	1	1
1396	0	0	0	1	1
1397	0	0	0	1	1
1399	0	0	0	1	1
1400	0	0	0	2	2
1402	0	0	0	2	2
1403	0	0	0	1	1
1404	0	0	0	1	1
1405	0	0	1	0	1
1406	0	0	0	3	3
1408	0	0	0	4	4
1409	0	0	0	2	2
1411	0	0	0	2	2
1412	0	0	1	0	1
1414	0	0	1	1	2
1415	0	0	0	2	2
1418	0	0	0	1	1
1419	0	0	0	2	2
1420	0	0	1	1	2
1421	0	0	0	5	5
1422	0	0	0	3	3
1423	0	0	0	2	2
1424	0	0	1	3	4
1425	0	0	0	1	1
1426	0	0	0	2	2
1427	0	0	1	0	1
1428	0	0	0	1	1
1429	0	0	0	2	2
1430	0	0	0	2	2
1431	0	0	0	1	1
1432	0	0	0	1	1
1433	0	0	1	0	1
1435	0	0	0	1	1
1436	0	0	0	1	1
1438	0	0	0	3	3
1439	0	0	0	2	2
1440	0	0	0	2	2
1443	0	0	0	1	1
1444	0	0	1	0	1
1445	0	0	0	2	2
1446	0	0	0	2	2
1447	0	0	0	1	1
1448	0	0	0	1	1
1449	0	0	0	1	1
1450	0	0	1	1	2
1451	0	0	0	1	1
1452	0	0	0	2	2
1454	0	0	0	1	1
1455	0	0	0	1	1
1459	0	0	0	1	1
1460	0	0	0	1	1
1462	0	0	0	2	2
1465	0	0	0	2	2
1466	0	0	0	1	1
1467	0	0	0	1	1
1469	0	0	1	0	1
1470	0	0	0	2	2
1471	0	0	0	2	2
1472	0	0	0	1	1
1474	0	0	0	1	1
1476	0	0	0	1	1
1477	0	0	0	1	1
1478	0	0	0	1	1
1479	0	0	0	2	2
1482	0	0	0	1	1
1483	0	0	1	0	1
1484	0	0	0	1	1
1487	0	0	1	0	1
1488	0	0	0	3	3
1489	0	0	0	1	1
1490	0	0	0	1	1
1491	0	0	0	2	2
1492	0	0	0	1	1
1493	0	0	1	0	1
1496	0	0	0	1	1
1498	0	0	0	2	2
1499	0	0	0	1	1
1500	0	0	2	0	2
1501	0	0	0	2	2
1503	0	0	0	1	1
1506	0	0	0	2	2
1508	0	0	0	1	1
1512	0	0	0	2	2
1513	0	0	0	1	1
1516	0	0	0	1	1
1518	0	0	0	2	2
1519	0	0	0	2	2
1520	0	0	1	1	2
1521	0	0	0	1	1
1522	0	0	0	3	3
1523	0	0	1	0	1
1524	0	0	0	1	1
1526	0	0	0	1	1
1527	0	0	0	1	1
1528	0	0	1	0	1
1530	0	0	0	1	1
1533	0	0	1	1	2
1535	0	0	0	1	1
1536	0	0	0	1	1
1537	0	0	0	1	1
1539	0	0	0	2	2
1543	0	0	1	1	2
1546	0	0	0	1	1
1547	0	0	0	1	1
1551	0	0	0	2	2
1552	0	0	0	1	1
1556	0	0	0	1	1
1557	0	0	0	1	1
1558	0	0	0	1	1
1559	0	0	0	1	1
1563	0	0	0	1	1
1564	0	0	0	3	3
1570	0	0	0	1	1
1571	0	0	0	1	1
1574	0	0	1	0	1
1575	0	0	0	1	1
1578	0	0	0	1	1
1579	0	0	0	1	1
1583	0	0	1	0	1
1587	0	0	0	1	1
1588	0	0	0	1	1
1589	0	0	0	1	1
1591	0	0	0	1	1
1592	0	0	1	1	2
1593	0	0	0	2	2
1594	0	0	0	1	1
1598	0	0	0	1	1
1600	0	0	0	1	1
1602	0	0	0	1	1
1603	0	0	0	2	2
1605	0	0	0	1	1
1606	0	0	0	1	1
1608	0	0	0	1	1
1611	0	0	1	0	1
1614	0	0	0	1	1
1618	0	0	0	1	1
1620	0	0	0	1	1
1621	0	0	0	1	1
1622	0	0	0	1	1
1623	0	0	1	1	2
1625	0	0	0	1	1
1627	0	0	1	0	1
1629	0	0	0	1	1
1630	0	0	0	1	1
1631	0	0	0	1	1
1633	0	0	0	2	2
1641	0	0	0	1	1
1644	0	0	0	1	1
1645	0	0	0	1	1
1649	0	0	0	1	1
1651	0	0	0	1	1
1652	0	0	0	2	2
1656	0	0	0	2	2
1657	0	0	0	1	1
1660	0	0	0	1	1
1662	0	0	0	2	2
1665	0	0	0	1	1
1669	0	0	0	1	1
1675	0	0	0	1	1
1683	0	0	0	1	1
1684	0	0	0	1	1
1685	0	0	0	1	1
1686	0	0	0	2	2
1687	0	0	0	1	1
1689	0	0	0	1	1
1692	0	0	0	1	1
1693	0	0	0	3	3
1694	0	0	0	1	1
1699	0	0	0	1	1
1703	0	0	0	1	1
1708	0	0	0	1	1
1709	0	0	0	1	1
1710	0	0	0	1	1
1711	0	0	0	2	2
1714	0	0	0	1	1
1718	0	0	0	2	2
1719	0	0	1	0	1
1721	0	0	1	0	1
1725	0	0	0	1	1
1727	0	0	0	1	1
1728	0	0	0	2	2
1741	0	0	0	1	1
1754	0	0	0	1	1
1757	0	0	0	1	1
1759	0	0	0	1	1
1761	0	0	0	1	1
1766	0	0	0	2	2
1770	0	0	0	1	1
1771	0	0	0	1	1
1773	0	0	0	2	2
1776	0	0	0	1	1
1778	0	0	0	1	1
1781	0	0	0	1	1
1785	0	0	0	1	1
1786	0	0	0	1	1
1791	0	0	0	2	2
1795	0	0	0	1	1
1798	0	0	0	1	1
1801	0	0	0	1	1
1802	0	0	1	0	1
1804	0	0	0	1	1
1811	0	0	0	1	1
1818	0	0	0	1	1
1821	0	0	0	1	1
1828	0	0	1	0	1
1829	0	0	0	1	1
1831	0	0	0	1	1
1837	0	0	0	1	1
1838	0	0	0	1	1
1857	0	0	0	1	1
1860	0	0	0	1	1
1872	0	0	0	1	1
1875	0	0	0	1	1
1879	0	0	0	1	1
1884	0	0	0	1	1
1893	0	0	0	1	1
1912	0	0	0	1	1
1922	0	0	0	1	1
1926	0	0	0	1	1
1934	0	0	0	1	1
1948	0	0	0	1	1
1952	0	0	0	1	1
1960	0	0	0	1	1
1962	0	0	0	1	1
1975	0	0	0	1	1
1989	0	0	0	1	1
2000	0	0	0	1	1
2009	0	0	0	1	1
2010	0	0	0	1	1
2033	0	0	1	0	1
2037	0	0	0	1	1
2039	0	0	0	1	1
2077	0	0	0	1	1
2086	0	0	1	0	1
2130	0	0	1	0	1
2132	0	0	0	1	1
2149	0	0	0	1	1
2151	0	0	0	1	1
2155	0	0	0	1	1
2181	0	0	0	1	1
2237	0	0	1	0	1
2246	0	0	0	1	1
2279	0	0	0	1	1
2303	0	0	0	1	1
2436	0	0	0	1	1
2443	0	0	0	1	1
2561	0	0	0	1	1
2758	0	0	0	1	1
2846	0	0	0	1	1
